ROUTE 5
BG:
*YZZZZZZZZZZZZZZZZZZZZZZZZZZZZZZZZZZZZZZZZZZZZZZZZZZZZZZZZZZZZZZZZZZZZZZZZZZZZZZZZZZZZZZZZ
*\`ZZZZZZZZZZZZZZZZZZZZZZZZZZZZZZZZZZZZZZZZZZZZZZZZZZZZZZZZZZZZZZZZZZZZZZZZZZZZZZZZZZZZZZZ
**YZZZZZZZZZZZZZZZZZZZZZZZZZZZZZZZZZZZZZZZZZZZZZZZZZZZZZZZZZZZZZZZZZZZZZZZZZZZZZZZZZZZZZZZ
**YZZZZZZZZZZZZZZZZZZZZZZZZZZZZZZZZZZZZZZZZZZZZZZZZZZZZZZZZZZZZZZZZZZZZZZZZZZZZZZZZZZZZZZZ
**YZZZZZZZZZZZZZZZZZZZZZZZZZZZZZZZZZZZZZZZZZZZZZZZZZZZZZZZZZZZZZZZZZZZZZZZZZZZZZZZZZZZZZZZ
**\]]]`ZZZZZZZZZZZZZZZZZZZZZZZZZZZZZZZZZZZZZZZZZZZZZZZZZZZZZZZZZZZZZZZZZZZZZZZZZZZZZZZZZZZ
******YZZZZZZZZZZZZZZZZZZZZZZZZZZZZZZZZZZZZZZZZZZZZZZZZZZZZZZZZZZZZZZZZZZZZZZZZZZZZZZZZZZZ
******\]]]]]`ZZZZZZZZZZZZZZZZZZZZZZZZZZZZZZZZZZZZZZZZZZZZZZZZZZZZZZZZZZZZZZZZZZZZZZZZZZZZZ
************YZZZZZZZZZZZZZZZZZZZZZZZZZZZZZZZZZZZZZZZZZZZZZZZZZZZZZZZZZZZZZZZZZZZZZZZZZZZZZ
************YZZZZZZZZZZZZZZZZZZZZZZZZZZZZZZZZZZZZZZZZZZZZZZZZZZZZZ_]]`ZZZZZZZZZZZZZZZZZZZZ
************YZZZZZZZZZZZZZZZZZZZZZZZZZZZZZZZZZZZZZZZZZZZZZZZZZZZZZ[**YZZZZZZZZZZZZZZZZZZZZ
*********ZZZZZZZZZZZZZZZZZZZZZZZZZZZZZZZZZZZZZZZZZZZZZZZZZZZZZZZZZ[**\]`ZZZZZZZZZZZZZZZZZZ
"""""xZZZZZZZZZZsZZZZZZZZZZZZZZZZZZZZZZZZZZZZZZZZZZZZZZZZZZZZZZZZ_^****YZZZZZZZZZZZZZZZZZZ
%%%%%wZZZZZZZZZZtZZZZZZZZZZZZZZZZZZZZZZZZZZZZZZZZZZZZZZZZZZZZZZZZ[****VbZZZZZZZZZZZZZZZZZZ
(((((vZZZZZZZZZZuZZZZZZZZZZZZZZZZZZZZZZZZZZZZZZZZZZZZZZZZZZZZZZZZaWWWWbZZZZZZZZZZZZZZZZZZZ
************YZZZZZZZZZZZZZZZZZZZZZZZZZZZZZZZZZZZZZZZZZZZZZZZZZZZZZZZZZZZZZZZZZZZZZZZZZZZZZ
***********VbZZZZZZZZZZZZZZZZZZZZZZZZZZZZZZZZZZZZZZZZZZZZZZZZZZZZZZZZZZZZZZZZZZZZZZZZZZZZZ
WWWWWWWWWWWZZZZZZZZZZZZZZZZZZZZZZZZZZZZZZZZZZZZZZZZZZZZZZZZZZZZZZZZZZZZZZZZZZZZZZZZZZZZZZZ
ZZZZZZZZZZZZZZZZZZZZZZZZZZZZZZZZZZZZZZZZZZZZZZZZZZZZZZZZZZZZZZZZZZZZZZZZZZZZZZZZZZZZZZZZZZ
ZZZZZZZZZZZZZZZZZZZZZZZZZZZZZZZZZZZZZZZZZZZZZZZZZZZZZZZZZZZZZZZZZZZZZZZZZZZZZZZZZZZZZZZZZZ
ZZZZZZZZZZZZZZZZZZZZZZZZZZZZZZZZZZZZZZZZZZZZZZZZZZZZZZZZZZZZZZZZZZZZZZZZZZZZZZZZZZZZZZZZZZ
ZZZZZZZZZZZZZZZZZZZZZZZZZZZZZZZZZZZZZZZZZZZZZZZZZZZZZZZZZZZZZZZZZZZZZZZZZZZZZZZZZZZZZZZZZZ
ZZZZZZZZZZZZZZZZZZZZZZZZZZZZZZZZZZZZZZZZZZZZZZZZyzzzzz{ZZZZZZZZZZZZZZZZZZZZZZZZZZZZZZZZZZZ
ZZZZZZZZZZZZZZZZZZZZZZZZZZZZZZZZZZZZZZZZZZZZZZZZZZZZZZZZZZZZZZZZZZZZZZZZZZZZZZZZZZZZZZZZZZ
ZZZZZZZZZZZZZZZZZZZZZZZZZZZZZZZZZZZZZZZZZZZZZZZZZZZZZZZZZZZZZZZZZZZZZZZZZZZZZZZZZZZZZZZZZZ
ZZZZZZZZZZZZZZZZZZZZZZZZZZZZZZZZZZZZZZZZZZZZZZZZZZZZZZZZZZZZZZZZZZZZZZZZZZZZZZZZZZZZZZZZZZ
ZZZZZZZZZZZZZZZZZZZZZZZZZZZZZZZZZZZZZZZZZZZZZZZZyzzzzz{ZZZZZZZZZZZZZZZZZZZZZZZZZZZZZZZZZZZ
ZZZZZZZZZZZZZZZZZZZZZZZZZZZZZZZZZZZZZZZZZZZZZZZZZZZZZZZZZZZZZZZZZZZZZZZZZZZZZZZZZZZZZZZZZZ
ZZZZZZZZZZZZZZZZZZZZZZZZZZZZZZZZZZZZZZZZZZZZZZZZZZZZZZZZZZZZZZZZZZZZZZZZZZZZZZZZZZZZZZZZZZ
ZZZZZZZZZZZZZZZZZZZZZZZZZZZZZZZZZZZZZZZZZZZZZZZZZZZZZZZZZZZZZZZZZZZZZZZZZZZZZZZZZZZZZZZZZZ
ZZZZZZZZZZZZZZZZZZZZZZZZZZZZZZZZZZZZZZZZZZZZZZZZZZZZZZZZZZZZZZZZZZZZZZZZZZZZZZZZZZZZZZZZZZ
ZZZZZZZZZZZZZZZZZZZZZZZZZZZZZZZZZZZZZZZZZZZZZZZZZZZZZZZZZZZZZZZZZZZZZZZZZZZZZZZZZZZZZZZZZZ
ZZZZZZZZZZZZZZZZZZZZZZZZZZZZZZZZZZZZZZZZZZZZZZZZZZZZZZZZZZZZZZZZZZZZZZZZZZZZZZZZZZZZZZZZZZ
ZZZZZZZZZZZZZZZZZZZZZZZZZZZZZZZZZZZZZZZZZZZZZZZZZZZZZZZZZZZZZZZZZZZZZZZZZZZZZZZZZZZZZZZZZZ
ZZZZZZZZZZZZZZZZZZZZZZZZZZZZZZZZZZZZZZZZZZZZZZZZZZZZZZZZZZZZZZZZZZZZZZZZZZZZZZZZZZZZZZZZZZ
ZZZZZZZZZZZZZZZZZZZZZZZZZZZZZZZZZZZZZZZZZZZZZZZZZZZZZZZZZZZZZZZZZZZZZZZZZZZZZZZZZZZZZZZZZZ
ZZZZZZZZZZZZZZZZZZZZZZZZZZZZZZZZZZZZZZZZZZZZZZZZZZZZZZZZZZZZZZZZZZZZZZZZZZZZZZZZZZZZZZZZZZ
ZZZZZZZZZZZZZZZZZZZZZZZZZZZZZZZZZZZZZZZZZZZZZZZZZZZZZZZZZZZZZZZZZZZZZZZZZZZZZZZZZZZZZZZZZZ
ZZZZZZZZZZZZZZZZZZZZZZZZZZZZZZZZZZZZZZZZZZZZZZZZZZZZZZZZZZZZZZZZZZZZZZZZZZZZZZZZZZZZZZZZZZ
ZZZZZZZZZZZZZZZZZZZZZZZZZZZZZZZZZZZZZZZZZZZZZZZZZZZZZZZZZZZZZZZZZZZZZZZZZZZZZZZZZZZZZZZZZZ
ZZZZZZZZZZZZZZZZZZZZZZZZZZZZZZZZZZZZZZZZZZZZZZZZZZZZZZZZZZZZZZZZZZZZZZZZZZZZZZZZZZZZZZZZZZ
ZZZZZZZZZZZZZZZZZZZZZZZZZZZZZZZZZZZZZZZZZZZZZZZZZZZZZZZZZZZZZZZZZZZZZZZZZZZZZZZZZZZZZZZZZZ
ZZZZZZZZZZZZZZZZZZZZZZZZZZZZZZZZZZZZZZZZZZZZZZZZZZZZZZZZZZZZZZZZZZZZZZZZZZZZZZZZZZZZZZZZZZ
ZZZZZZZZZZZZZZZZZZZZZZZZZZZZZZZZZZZZZZZZZZZZZZZZZZZZZZZZZZZZZZZZZZZZZZZZZZZZZZZZZZZZZZZZZZ
ZZZZZZZZZZZZZZZZZZZZZZZZZZZZZZZZZZZZZZZZZZZZZZZZZZZZZZZZZZZZZZZZZZZZZZZZZZZZZZZZZZZZZZZZZZ
ZZZZZZZZZZZZZZZZZZZZZZZZZZZZZZZZZZZZZZZZZZZZZZZZZZZZZZZZZZZZZZZZZZZZZZZZZZZZZZZZZZZZZZZZZZ
ZZZZZZZZZZZZZZZZZZZZZZZZZZZZZZZZZZZZZZZZZZZZZZZZZZZZZZZZZZZZZZZZZZZZZZZZZZZZZZZZZZZZZZZZZZ
ZZZZZZZZZZZZZZZZZZZZZZZZZZZZZZZZZZZZZZZZZZZZZZZZZZZZZZZZZZZZZZZZZZZZZZZZZZZZZZZZZZZZZZZZZZ
ZZZZZZZZZZZZZZZZZZZZZZZZZZZZZZZZZZZZZZZZZZZZZZZZZZZZZZZZZZZZZZZZZZZZZZZZZZZZZZZZZZZZZZZZZZ
ZZZZZZZZZZZZZZZZZZZZZZZZZZZZZZZZZZZZZZZZZZZZZZZZZZZZZZZZZZZZZZZZZZZZZZZZZZZZZZZZZZZZZZZZZZ
ZZZZZZZZZZZZZZZZZZZZZZZZZZZZZZZZZZZZZZZZZZZZZZZZZZZZZZZZZZZZZZZZZZZZZZZZZZZZZZZZZZZZZZZZZZ
ZZZZZZZZZZZZZZZZZZZZZZZZZZZZZZZZZZZZZZZZZZZZZZZZZZZZZZZZZZZZZZZZZZZZZZZZZZZZZZZZZZZZZZZZZZ
ZZZZZZZZZZZZZZZZZZZZZZZZZZZZZZZZZZZZZZZZZZZZZZZZZZZZZZZZZZZZZZZZZZZZZZZZZZZZZZZZZZZZZZZZZZ
ZZZZZZZZZZZZZZZZZZZZZZZZZZZZZZZZZZZZZZZZZZZZZZZZZZZZZZZZZZZZZZZZZZZZZZZZZZZZZZZZZZZZZZZZZZ
ZZZZZZZZZZZZZZZZZZZZZZZZZZZZZZZZZZZZZZZZZZZZZZZZZZZZZZZZZZZZZZZZZZZZZZZZZZZZZZZZZZZZZZZZZZ
COL:
 8 88 566666666666666666666666666666666666666666666666666666666666666666666>     8        
 5>88          =66666666666666666666>          =66666>                     8     5666>    
  888  WX      9    =6666>          5666>      9     56666666666666>       8         8    
  88566666666667  =67    5666666> V     56666667                   8       5666666>  8    
  856666>      =667             56666666666666666666666666666>     8              8  56666
  5666> 8 V    9                                             8     8              8       
      8 56666667     WX                                      8     8              56666666
  $%& 566666>                   WX                           8     5666>                  
  !"#       8                                                8         8                  
            5666666666666666666666666666666666666666666>V WX 8    $%&  5666>              
      noooooooop        |||||||||||||||||||||          8 V  V8    !-,      8              
      kllllllllm            |||||||||||||||            8|||V 566>  $%&     8              
      kllllllllm          ||||||||||||||||||           8||WX||||8  !"#     8              
      hiiiiiiiij      |||||||||V||||||||||             8 |||||||8          8         :;;;;
      effffffffg            |||||||||||                8   |||||8        :;4         8    
      bccccccccd  |||||||||||||||||||||||||||          8  ||||||5666>    8           8    
                V       |||||||||||||||||||            8   |||||||||8    8    :;;;;;;4    
;;;;;;;;;;;;;;;;;;;;;;;;;;;;;;;;;;;;;;;;;;;;;;;<       8    ||||||||8:;;;4    8           
                                               9       8 |||||||||||88        5666>       
                          :;;;;;;;;;;;;<       9       8  ||||||||||88            8       
;;;;;;;;;;;;;<         :;;4||||||||||||9       9       8     :;;;;;;48    :;<     56666666
             3;;;;;;;;;4|||||||||||||||3;<     9       8     8       8   :4 9             
                     V|||||||||||||||||||3;;;;<3       4     8 :;;;;;4   8  9             
;;;;;;;;;;;;;;;;;;;;;;;;<||||||||||||||       9              8 8         8  9             
                        9|||||WX||||:;;;;;;;< 9           :;;4 8   V  :;;4  3;;;;;;;;;;;;;
;;;;;;;;;;;;;;;;<       9|||||||||||8       9 9           8    566666>8                   
                3;;<    3;<|||||||||8   V   9 3;       ;;;4    `     88                   
66666666666666666667      3;;;;;;;;;4       9                        88  V                
                                            9                        z8       WX          
                                            9                        88                   
666666666666666666666666666666666>    WX    9                      :;456666666666666666666
66666666666666666666666666666666>8          9                 :;;;;4                  V   
66666666666666666>            V 8566666666667                 566666666>     WX           
HIIIIIIIIIIIIIIIJ566666666666>  56666666666>               ||||||||||||566>     :;;;;;;;;;
KLLLLLLLLLLLLLLLSIIIIIIIIIIIJ5666666666666>8         :;;;<||||||||||||||||5>    8         
KLLLLLLLLLLLLLLLLLLLLULLLLLLSIIIIIIIIIIIIJ88         8  V3;<|||||||||||||||8    8         
KLLLLLLLLLLLLLLLLLLLLLLLLLLLLLLLLLLLLLLLLM88:;;;;;;;;4     9|||||||||||WX||8 :;;4         
NOOOOOOOOOOOOOOOOOOORLLLLLLLLLULLLLLLLLLLM888              9||||V||||||||||8 8      WX    
;;;;;;;;;;;;;;;;;;;<NOORLLLLLLLLLLLLLLLQOP885666666666666667|||||||||||||||8 8            
;;;;;;;;;;;;;;;;;;<3;;<NOOOOOOOOOOOOOOOP:;48              |||||||||||||||||8 8            
;;;;;;;;;;;;<   V 9   3;;;;;;;;;;;;;;;;;4  8            |||||||||||||||:;;;4 8 V          
;;;;;;<     3;;<  3;;;;;;;;;;;;;;;;;;;;;;;;4               |||||:;;;;;;4     8     :;;;;;;
      3;;;;;;;<9                                          :;;;;;4         :;;4     8      
              99                                V         8      :;;;;;;;;4        8      
       WX     99                                      :;;;4 :;;;;4                 8      
              93;;;;;;;;;;;;;;;;;;;;;;;;;;;;;;;;;;;;;;4     8                 :;;;;4      
;;;;;;;;;;;;;<3;;;;;;<                      V               8                 8       WX  
          V  9       3;;;;<      WX                     :;;;4         WX      8           
;;;;;;;;<    9            3;;;;;;;;;;;;;;;;;;;;;;;;;;;;;4                :;;;;4           
        3;;< 3;;;;;;;;;;;;;;;;;<                             V           8                
      WX   9                   3;;;;;;;;;;<                     :;;;;;;;;4     V          
           9               V              3;;;;;;;;;;;;;;;;;;;;;4                         
           3;;;;;;;;;;;;;<                            WX                  V               
                         3;;;;;;;;<                                                       
                                  3;;;;<                                                  
TOP:

       56



                     56
  !"%                           56

                                                          56      !"%

                                                                     %
                                                          56











                              56



                                                                     CD       56
                                                                     AB
                                      56                             @

                                                                             56



                                                                       56
                                                                                    56






       56

                 JKL                                                                  56
                                 56                                   56


      56

                                                      56
END
assets/textures/tiling/ground.png
assets/textures/tiling/colroad.png
assets/textures/tiling/toproad.png
N;0;0
S;18;44
O;16;13
E;68;28
null
ROAD;8;56;54
CITY;4;50;16
ROAD;5;15;13
TRAINERS:
NULL
POKEMONS:
30:17;20;27;50;54;67;74;75;88;90;92;95
SIGNS:
NULL
ARENA:
NULL
CENTER:
NULL
SHOP:
NULL